@@@@@@@@@@@@@@@@
@...@@@...@.@@@@
@.@@...........@
@.@@@.@@@@.@.@@@
@.@@..@@.@@@.@@@
@.@@.@@@.@@@@@@@
@.@@..@@.....@@@
@.@@.....@@@..@@
@.@@@.@@.@@..@@@
@.@@..@@@@@@.@@@
@.@..@@......@@@
@.@@@@...@@@.@@@
@.......@@@@.@@@
@.@@.@@@@@.@.@.@
@.@..@@@@......@
@@@@@@@@@@@@@@@@